0 1 2
__S_______BB______S_______BB_________S__
__________BB______________BB____________
__________BB______________BB____________
__________BB___BBBBBBBB___BB____________
____BB____BB___BBBBBBBB___BB____BB______
____BB____BB___BB____BB___BB____BB______
____BB_________BB____BB_________BB______
____BB_________BB____BB_________BB______
____BB_________BB____BB_________BB______
____BB_________BB____BB_________BB______
____BB____BB___BB____BB___BB____BB______
____BB____BB___BBBBBBBB___BB____BB______
____BB____BB___BBBBBBBB___BB____BB______
____BB____BB_____CCCC_____BB____BB______
____BB____BB______________BB____BB______
____BBBBBBBB______________BBBBBBBB______
________________________________________
________________________________________
__BBBBBBBBBBBBBBB____BBBBBBBBBBBBBBB____
__BBBBBBBBBBBBBBB____BBBBBBBBBBBBBBB____
________________________________________
________________________________________
__BB____________________________________
__BB______________________________BB____
__BB______BB______________BB______BB____
__BB______BB______P_______BB______BB____
__BB______BB______________BB______BB____
__BB______BB_____BBBB_____BB______BB____
__________BB_____BX_B_____BB____________
__________BB_____B__B_____BB____________
