0 1 2
__S__________________________________S__
________________________________________
__BBBBBBBBBBBBBBBBBBBBBBBBBBBBBBBBBBBB__
__BBBBBBBBBBBBBBBBBBBBBBBBBBBBBBBBBBBB__
________________________________________
________________________________________
________________________________________
_______C______________________^^^^______
_______C______________________^^^^______
_______C______________________^^^^______
_______C______________________^^^^______
_______C________________________________
_______C______________________~~________
_______C______________________~~________
_______C______________________~~________
_______C______________________~~________
_______C________________________________
_______C________________________________
_______C________________________________
_______C________________________________
________________________________________
________________________________________
________________________________________
__BBBBBBBBBBBBBBBBBBBBBBBBBBBBBBBBBBBB__
__BBBBBBBBBBBBBBBBBBBBBBBBBBBBBBBBBBBB__
__________________P_____________________
________________________________________
_________________BBBB___________________
_________________BX_B___________________
_________________B__B___________________