size=40,28
spawncount=3
        15000:0             30000:0         45000:0
3000:0             25000:0  30000:0 40000:0
        15000:0             30000:0         45000:0
BB__________BB____________BB__________BB
BB__________BB____________BB__________BB
BB__S___BB__BB____S_______BB__BB__S___BB
BB______BB__BB____________BB__BB______BB
BB______BB__BB____________BB__BB______BB
BB______BB__BB____________BB__BB______BB
BB__BBBBBB__BB____________BB__BBBBBB__BB
BB__BBBBBB__BB____________BB__BBBBBB__BB
BB______BB______BBBBBBBB______BB______BB
BB______BB______BBBBBBBB______BB______BB
________________________________________
________________________________________
__BBBBBBBBBBBBBBBB__BBBBBBBBBBBBBBBBBB__
__BBBBBBBBBBBBBBBB__BBBBBBBBBBBBBBBBBB__
________BB____________________BB________
________BB____________________BB________
BB__BB__BB__BBBBBBBBBBBBBBBB__BB__BB__BB
BB__BB__BB__BBBBBBBBBBBBBBBB__BB__BB__BB
BBBBBB__BB____________________BB__BBBBBB
BBBBBB__BB____________________BB__BBBBBB
BB__________BB____________BB__________BB
BB__________BB____________BB__________BB
BB__BBBBBB__BB____P_______BB__BBBBBB__BB
BB__BBBBBB__BB____________BB__BBBBBB__BB
BB__BBBBBB__BB__BBBBBB____BB__BBBBBB__BB
BB__BBBBBB__BB__BBBBBB____BB__BBBBBB__BB
BB__BBBBBB__BB__BBX_BB____BB__BBBBBB__BB
BB__BBBBBB__BB__BB__BB____BB__BBBBBB__BB
