size=38,28
spawncount=3
        15:1             30:0             70:1
3:0             25:3              55:3 65:3
        15:1             30:0             70:1
CCCCCCCCCCCCCCS___S___S_CCCCCCCCCCCCCC
__BB_________C__________C_________BB__
__BB______________________________BB__
__BB______________________________BB__
__BBBBBB__BBBB__BB__BB__BBBB__BBBBBB__
__BBBBBB__BBBB__BB__BB__BBBB__BBBBBB__
__________BB______________BB__________
__________BB______________BB__________
BBBBBBBB__BBBBBBBBBBBBBBBBBB__BBBBBBBB
BBBBBBBB__BBBBBBBBBBBBBBBBBB__BBBBBBBB
~~~~~~BB__BB______BB______BB__BB~~~~~~
~~~~~~BB__BB______BB______BB__BB~~~~~~
~~~~~~____________BB____________~~~~~~
~~~~~~____________BB____________~~~~~~
~~~~~~____________BB____________~~~~~~
~~~~~~____________BB____________~~~~~~
~~~~~~______BBBBBBBBBBBBBB______~~~~~~
~~~~~~______BBBBBBBBBBBBBB______~~~~~~
~~~~~~__________________________~~~~~~
~~~~~~__________________________~~~~~~
~~~~~~______BB__________BB______~~~~~~
~~~~~~______BB__________BB______~~~~~~
~~~~~~_____BBB____P_____BBB_____~~~~~~
~~~~~~____BBBB__________BBBB____~~~~~~
~~~~~~____BB____BBBBBB____BB____~~~~~~
~~~~~~____BB____BBBBBB____BB____~~~~~~
~~~~~~____BB____BBX_BB____BB____~~~~~~
~~~~~~____BB____BB__BB____BB____~~~~~~
