size=38,28
spawncount=3
        15:0             30:0             50:0
3:0             25:0              40:0 50:0
        15:0             30:0             50:0
S_____BB__________S___________BB____S_
______BB______________________BB______
______BB__BBBBBBBB__BBBBBBBB__BB______
______BB__BBBBBBBB__BBBBBBBB__BB______
__BBBBBB______________________BBBBBB__
__BBBBBB______________________BBBBBB__
______BBBB____BBBBBBBBBB____BBBB______
______BBBB____BBBBBBBBBB____BBBB______
______________________________________
______________________________________
BBBBBBBBBBBBBBBBBBBBBBBBBBBBBBBBBBBBBB
BBBBBBBBBBBBBBBBBBBBBBBBBBBBBBBBBBBBBB
__CCCCCCCCCCCCCCCC__CCCCCCCCCCCCCCCC__
__CCCCCCCCCCCCCCCC__CCCCCCCCCCCCCCCC__
______________________________________
______________________________________
__BBBBBBB___________________BBBBBBBB__
__BBBBBBBB_________________BBBBBBBBB__
_______________BBBBBBBB_______________
______________BBBBBBBBBB______________
___________B______________B___________
_______B__BB______________BB__B_______
______BB__BB______P_______BB__BB______
______BB__BB______________BB__BB______
______BB__BB____BBBBBB____BB__BB______
______BB__BB____BBBBBB____BB__BB______
______BB__BB____BBX_BB____BB__BB______
______BB__BB____BB__BB____BB__BB______
