size=38,28
spawncount=3
        15:0             30:0             50:0
3:0             25:0              40:0    50:0
        15:0             30:0             50:0
__S___BBCCBB____CCS_CC____BBCCBB__S___
______BBCCBB____CC__CC____BBCCBB______
______BBBBBB_____C__C_____BBBBBB______
______BBBBBB______________BBBBBB______
BB______________BB__BB______________BB
BB______________BB__BB______________BB
BB__BBBBBBBBBB__BB__BB__BBBBBBBBBB__BB
BB__BBBBBBBBBB__BB__BB__BBBBBBBBBB__BB
______BB__BB____BBBBBB____BB__BB______
______BB__BB____BBBBBB____BB__BB______
______________________________________
______________________________________
______________________________________
_________~~~~~~~~~~~~~~~~~~~~_________
BBB__BBB~~~~~~~~~~~~~~~~~~~~~~BBB__BBB
BBB__BBB~~~~~~~~~~~~~~~~~~~~~~BBB__BBB
BB____BB~~CCCCBBBBBBBBBBCCCC~~BB____BB
BB____BB~~C___BBBBBBBBBB___C~~BB____BB
______________________________________
______________________________________
________~~C________________C~~________
_______~~~C________________C~~~_______
_______~~~C_______P________C~~~_______
_______~~~C________________C~~~_______
__BB___~~~C_____BBBBBB_____C~~~___BB__
__BB____~~C_____BBBBBB_____C~~____BB__
__BB____________BBX_BB____________BB__
__BB____________BB__BB____________BB__
