size=38,28
spawncount=3
        15:1             30:0             50:0
3:0             25:0              40:0 50:2
        15:1             30:0             50:0
__S________BB_____S______BB_______S___
__________BBBB__________BBBB__________
________BBBBBBBB______BBBBBBBB________
________BB____BB______BB____BB________
________BB____BB______BB____BB________
________BB____BB______BB____BB________
BB____BBBBBBBBBBBB__BBBBBBBBBBBB____BB
BB____BBBBBBBBBBBB__BBBBBBBBBBBB^___BB
__^^_____^^^^^^^^^^^______^^^^^^^^^^__
^^^^^^^^^^^^^^^^^^^^^___^^^^^^^^^^^^^_
^^^^^^^^^^^^^^^^^^^^^^^^^^^^^^^^^^^^^^
^^^^^^^^^^^^^^^^^^^^^^^^^^^^^^^^^^^^^^
^^BBBBBBBB^^^^BBBBBBBBBB^^^^BBBBBBBB^^
^^BBBBBBBB^^^^BBBBBBBBBB^^^^BBBBBBBB^^
^^^^^^^^^^^^^^^^^^^^^^^^^^^^^^^^^^^^^^
^^^^^^^^^^^^^^^^^^^^^^^^^^^^^^^^^^^^^^
^^^^^^^^^^^^^^^^^^^^^^^^^^^^^^^^^^^^^^
^^^^^^^^^^^^^^^^^^^^^^^^^^^^^^^^^^^^^^
^^^^^^BBBBBBBBBBBB^^BBBBBBBBBBBB^^^^__
_^^^^^BBBBBBBBBBBB__BBBBBBBBBBBB^^^___
__^^^^________________________________
______________________________________
____BB____BB______P_______BB____BB____
____BB____BB______________BB____BB____
____BB____BB____BBBBBB____BB____BB____
____BB____BB____BBBBBB____BB____BB____
____BB__________BBX_BB__________BB____
____BB__________BB__BB__________BB____
