size=38,28
spawncount=4
        15:0             30:0           60:3
3:0             25:0              45:0          70:0
3:0             25:0              45:0          70:0
        15:0             30:3           60:0
CCCCCCCCCCCCCCCCCCS_CCCCCCCCCCCCCCCCCC
C^^^^^___________C__C___________~~~~~C
C^^^^^___________________________~~~~C
C^^^^___________BBBBBB____________~~~C
C^^^___________BBBBBBBB____________~~C
C^^___________BBCCCCCCBB____________~C
C____________________________________C
C____________________________________C
C__________B______________B__________C
C_________BB______________BB_________C
C______B__BB____BBBBBB____BB__B______C
CC____BB__BB____BBBBBB____BB__BB____CC
S_____BB__BB____BBX_BB____BB__BB____S_
______BB__BB____BB__BB____BB__BB______
CC____BB__BB____BBBBBB____BB__BB____CC
C______B__BB____BBBBBB____BB__B______C
C_________BB______________BB_________C
C__________B______________B__________C
C_________________P__________________C
C____________________________________C
C_____________BBCCCCCCBB_____________C
C______________BBBBBBBB______________C
C~______________BBBBBB_____________^^C
C~~_______________________________^^^C
C~~~_____________________________^^^^C
C~~~~___________________________^^^^^C
C~~~~~___________CS_C__________^^^^^^C
CCCCCCCCCCCCCCCCCC__CCCCCCCCCCCCCCCCCC
