size=38,28
spawncount=3
        15:0             30:0             50:0
3:0             25:0              40:0 50:0
        15:0             30:0             50:0
BB__________BB__________BB__________BB
BB__________BB__________BB__________BB
BB__S___BB__BB____S_____BB__BB__S___BB
BB______BB__BB__________BB__BB______BB
BB______BB__BB__~~~~~~__BB__BB______BB
BB______BB__BB__~~~~~~__BB__BB______BB
BB__BBBBBB__BB__~~~~~~__BB__BBBBBB__BB
BB__BBBBBB__BB__~~~~~~__BB__BBBBBB__BB
BB______BB______CCCCCC______BB______BB
BB______BB______CCCCCC______BB______BB
_______________^^^^^^^^_______________
_______________^^^^^^^^_______________
__BBBBBBBBBBBBBBBB^^BBBBBBBBBBBBBBBB__
__BBBBBBBBBBBBBBBB^^BBBBBBBBBBBBBBBB__
________BB____^^^^^^^^^^^___BB________
________BB____^^^^^^^^^^^___BB________
BB__BB__BB__BBBBBBBBBBBBBB__BB__BB__BB
BB__BB__BB__BBBBBBBBBBBBBB__BB__BB__BB
BBBBBB__BB__________________BB__BBBBBB
BBBBBB__BB__________________BB__BBBBBB
BB__________BB__________BB__________BB
BB__________BB__________BB__________BB
BB__BBBBBB__BB____P_____BB__BBBBBB__BB
BB__BBBBBB__BB__________BB__BBBBBB__BB
BB__BBBBBB__BB__BBBBBB__BB__BBBBBB__BB
BB__BBBBBB__BB__BBBBBB__BB__BBBBBB__BB
BB__BBBBBB__BB__BBX_BB__BB__BBBBBB__BB
BB__BBBBBB__BB__BB__BB__BB__BBBBBB__BB
