0 1 2
__S_______BB______S_______BB_________S__
__________BB______________BB____________
__________BB______________BB____________
__________BB___BBBBBBBB___BB____________
_B__BBCCCCBB___BBBBBBBB___BB____BB______
_B__BB__B_BB___BB____BB___BB____BB______
_B__BB__B______BB____BB_________BB______
_B__BB__B______BB____BB_________BB______
____BB_________BB____BB_________BB______
____CB_________BB____BB_________BB______
__BBBB____BB___BB____BB___BB____BB______
__BBBB____BB___BBBBBBBB___BB____BB______
____BB____BB___BBBBBBBB___BB____BB______
BB__BBBBBBBB______________BBBBBBBB______
________________________________________
________________________________________
BBBBBBB__BBBBBBBBBBBBBBBBBBBBBBBBBBBBBBB
_________BBBBBBBBBBBBBBBBBBBBBBBBBBBBBBB
_________BBB__B_________________________
__BBBBBBBBBB__B_________________________
__BB__________B_________________________
__BB__________B___________________BB____
__BB__BBBBBB__B___________BB______BB____
__BB______BB__B___P_______BB______BB____
__BB______BB__B___________BB______BB____
__BBBBBB__BB__B__BBBB_____BB______BB____
__________BB_____BX_B_____BB____________
__________BB_____B__B_____BB____________
